Dots	…	記号	
Ldots	...	記号	
Cdots	⋯	記号	
Cdots	…	記号	
Cdot	⋅	記号	
Vdots	⋮	記号	
Ddots	⋱	記号	
Iddots	⋰	記号	
Parallel	∥	記号	
Nparallel	∦	記号	
Leq	≤	記号	
Geq	≥	記号	
Doteq	≐	記号	
Asymp	≍	記号	
Bowtie	⋈	記号	
Ll	≪	記号	
Gg	≫	記号	
Equiv	≡	記号	
Vdash	⊢	記号	
Dashv	⊣	記号	
Subset	⊂	記号	
Supset	⊃	記号	
Approx	≈	記号	
In	∈	記号	
Ni	∋	記号	
Subseteq	⊆	記号	
Supseteq	⊇	記号	
Cong	≅	記号	
Smile	⌣	記号	
Frown	⌢	記号	
Sqsubset	⊏	記号	
Sqsupset	⊐	記号	
Simeq	≃	記号	
Models	⊨	記号	
Notin	∉	記号	
Sqsubseteq	⊑	記号	
Sqsupseteq	⊒	記号	
Sim	∼	記号	
Perp	⊥	記号	
Mid	∣	記号	
Prec	≺	記号	
Succ	≻	記号	
Propto	∝	記号	
Preceq	⪯	記号	
Succeq	⪰	記号	
Neq	≠	記号	
Pm	±	記号	
Cap	∩	記号	
Diamond	⋄	記号	
Oplus	⊕	記号	
Mp	∓	記号	
Cup	∪	記号	
Bigtriangleup	△	記号	
Ominus	⊖	記号	
Times	×	記号	
Uplus	⊎	記号	
Bigtriangledown	▽	記号	
Otimes	⊗	記号	
Div	÷	記号	
Sqcap	⊓	記号	
Triangleleft	◃	記号	
Oslash	⊘	記号	
Ast	∗	記号	
Sqcup	⊔	記号	
Triangleright	▹	記号	
Odot	⊙	記号	
Star	⋆	記号	
Vee	∨	記号	
Bigcirc	◯	記号	
Circ	∘	記号	
Dagger	†	記号	
Wedge	∧	記号	
Bullet	∙	記号	
Setminus	∖	記号	
Ddagger	‡	記号	
Wr	≀	記号	
Amalg	⨿	記号	
Exists	∃	記号	
Rightarrow	→	記号	
To	→	記号	
Nexists	∄	記号	
Leftarrow	←	記号	
Gets	←	記号	
Forall	∀	記号	
Mapsto	↦	記号	
Neg	¬	記号	
Implies	⟹	記号	
Implies	→	記号	
Rightarrow	⇒	記号	
Leftrightarrow	↔	記号	
Iff	⟺	記号	
Iff	↔	記号	
Leftrightarrow	⇔	記号	
Top	⊤	記号	
Land	∧	記号	
Bot	⊥	記号	
Lor	∨	記号	
Emptyset	∅	記号	
Varnothing	∅	記号	
|	∥	記号	
Backslash	∖	記号	
{	{	記号	
}	}	記号	
Langle	⟨	記号	
Rangle	⟩	記号	
Uparrow	↑	記号	
Uparrow	⇑	記号	
Lceil	⌈	記号	
Rceil	⌉	記号	
Downarrow	↓	記号	
Downarrow	⇓	記号	
Lfloor	⌊	記号	
Rfloor	⌋	記号	
Alpha	Α	記号	
Alpha	α	記号	
Nu	Ν	記号	
Nu	ν	記号	
Beta	Β	記号	
Beta	β	記号	
Xi	Ξ	記号	
Xi	ξ	記号	
Gamma	Γ	記号	
Gamma	γ	記号	
Omicron	Ο	記号	
Omicron	ο	記号	
Delta	Δ	記号	
Delta	δ	記号	
Pi	Π	記号	
Pi	π	記号	
Varpi	ϖ	記号	
Epsilon	Ε	記号	
Epsilon	ϵ	記号	
Varepsilon	ε	記号	
Rho	Ρ	記号	
Rho	ρ	記号	
Varrho	ϱ	記号	
Zeta	Ζ	記号	
Zeta	ζ	記号	
Sigma	Σ	記号	
Sigma	σ	記号	
Varsigma	ς	記号	
Eta	Η	記号	
Eta	η	記号	
Tau	Τ	記号	
Tau	τ	記号	
Theta	Θ	記号	
Theta	θ	記号	
Vartheta	ϑ	記号	
Upsilon	Υ	記号	
Upsilon	υ	記号	
Iota	Ι	記号	
Iota	ι	記号	
Phi	Φ	記号	
Phi	ϕ	記号	
Varphi	φ	記号	
Kappa	Κ	記号	
Kappa	κ	記号	
Varkappa	ϰ	記号	
Chi	Χ	記号	
Chi	χ	記号	
Lambda	Λ	記号	
Lambda	λ	記号	
Psi	Ψ	記号	
Psi	ψ	記号	
Mu	Μ	記号	
Mu	μ	記号	
Omega	Ω	記号	
Omega	ω	記号	
Partial	∂	記号	
Nabla	∇	記号	
Aleph	ℵ	記号	
Eth	ð	記号	
Box	□	記号	
Beth	ℶ	記号	
Hbar	ℏ	記号	
Ell	ℓ	記号	
Wp	℘	記号	
Infty	∞	記号	
Gimel	ℷ	記号	
Prod	Π	記号	
Prodn	∏	名詞	
Coprod	⨿	名詞	
Coprodn	∐	名詞	
